111111111111111111111111111111111111
10000001C100000000000000000000000001
10E00000000000000000000000000000P001
100000000001010101010100100110000001
111111111111111111111111111111111111
