11111111111111111111111111111111111111111111111111111111111111111111111111111111
10000000000000000000000000000000000000000000000000000000000000000000000000000001
10000000000000000000000000000000000000E00000000000000000000000000000000000000001
1CCCCCCCCCCCCCCCCCCCCCCCCCCCCCCCCCCCCCCCCCCCCCCCCCCCCCCCCCCCCCCCCCCCCCCCCCCCCCC1
10000000000000000000000000000000000000000000000000000000000000000000000000000001
10000000000000000000000000000000000000000000000000000000000000000000000000000001
10000000000000000000000000000000000000000000000000000000000000000000000000000001
10000000000000000000000000000000000000000000000000000000000000000000000000000001
10000000000000000000000000000000000000000000000000000000000000000000000000000001
10000000000000000000000000000000000000000000000000000000000000000000000000000001
10000000000000000000000000000000000000000000000000000000000000000000000000000001
10000000000000000000000000000000000000000000000000000000000000000000000000000001
10000000000000000000000000000000000000000000000000000000000000000000000000000001
10000000000000000000000000000000000000P00000000000000000000000000000000000000001
10000000000000000000000000000000000000000000000000000000000000000000000000000001
10000000000000000000000000000000000000000000000000000000000000000000000000000001
10000000000000000000000000000000000000000000000000000000000000000000000000000001
1000000000000000CCCCCC000000000000000000000000000000000000CCCCCC0000000000000001
1000000000000000000000C0000000000000000000000000000000000C0000000000000000000001
10000000000000000000000C00000000000000000000000000000000C00000000000000000000001
1000000000000000000CC000CC0000000000000000000000000000CC000CC0000000000000000001
10000000000000000CCCCCCC00C00000000000000000000000000C00CCCCCCC00000000000000001
10000000000000000CCCCCCCCC0C000000000000000000000000C0CCCCCCCCC00000000000000001
10000000000000000CCCCCCCCCC00000000000000000000000000CCCCCCCCCC00000000000000001
100000000000000000CCCCCCCC0000000000000000000000000000CCCCCCCC000000000000000001
10000000000000000000000000000000000000000000000000000000000000000000000000000001
10000000000000000000000000000000000000000000000000000000000000000000000000000001
10000000000000000000000000000000000000000000000000000000000000000000000000000001
10000000000000000CCCCCCCCCCCCCCCCCCCCCCCCCCCCCCCCCCCCCCCCCCCCCC00000000000000001
10000000000000000C00000000000000000000000000000000000000000000C00000000000000001
10000000000000000CC000000000000000000000000000000000000000000CC00000000000000001
100000000000000000CC0000000000000000000000000000000000000000CC000000000000000001
1000000000000000000CC00000000000000000000000000000000000000CC0000000000000000001
10000000000000000000CC000000000000000000000000000000000000CC00000000000000000001
100000000000000000000CC0000000000000000000000000000000000CC000000000000000000001
1000000000000000000000CCCCCCCCCCCCCCCCCCCCCCCCCCCCCCCCCCCC0000000000000000000001
10000000000000000000000000000000000000000000000000000000000000000000000000000001
10000000000000000000000000000000000000000000000000000000000000000000000000000001
10000000000000000000000000000000000000000000000000000000000000000000000000000001
10000000000000000000000000000000000000000000000000000000000000000000000000000001
10000000000000000000000000000000000000000000000000000000000000000000000000000001
10000000000000000000000000000000000000000000000000000000000000000000000000000001
11111111111111111111111111111111111111111111111111111111111111111111111111111111
