11111111111111111111111111111111111111111111111111111111111111111111111111111111
1P000000000000000000000000000000000000000000000000000000000000000000000000000001
10010000000000000000000000000000000000000000000000000001111111111111111111100011
10010000000000000000000000000000000000000000000000000001000000000000000100101101
10010000000000000000000000000000000000000000000000000001000111111111000100101001
10010000000000000000000000000000000000000000000000000001000100000001000100101001
10010000000000000000000000000000000000000000000000000001000111001111000100101001
10010000000000000000000000000000000000000000000000000001000100100100000100111001
10011111011110000000000000000000000000000000000000000001000100100100100100101001
10000001000000000000000000000000000000000000000000000001000100100100100100101001
10000001000000000000000000000000000000000000000000000001000100100100100100101001
10000001000000000000000000000000000000000000000000000001000100100100100100101001
10000001000000000000000000000000000000000000000000000001000100100100100100101001
10000001000000000000000000000000000000000000000000000001CEC100000000100100101001
10000001000000000000000000000000000000000000000000000000111000000000000100101001
100000010000000000000000000000000000000000000000000000000000C1111111111100101001
10000001000000000000000000000000000000000000000000000000000000000000000000101001
10000001000000000000000000000000000000000111111111111111111111111111111111101001
10000001000000000000000000000000000000000100000000000000000000000000000000001001
10000001000000000000000000000000000000000100000000000000000000000000000000000001
10000001000000000000000000000000000000000100000000000000000000000000000000000001
10000001000000000000000000000000000000000100000000000000000000000000000000000001
10000001000000000000000000000000000000000100000000000000000000000000000000000001
10000001000000000000000000000000000000000100000000000000000000000000000000000001
10000001111111111111111111111111111111111100000000000000000000000000000000000001
10000000000000000000000000000000000000000000000000000000000000000000000000000001
10000000000000000000000000000000000000000000000000000000000000000000000000000001
10000000000000000000000000000000000000000000000000000000000000000000000000000001
10000000000000000000000000000000000000000000000000000000000000000000000000000001
10000000000000000000000000000000000000000000000000000000000000000000000000000001
10000000000000000000000000000000000000000000000000000000000000000000000000000001
10000000000000000000000000000000000000000000000000000000000000000000000000000001
10000000000000000000000000000000000000000000000000000000000000000000000000000001
10000000000000000000000000000000000000000000000000000000000000000000000000000001
10000000000000000000000000000000000000000000000000000000000000000000000000000001
10000000000000000000000000000000000000000000000000000000000000000000000000000001
10000000000000000000000000000000000000000000000000000000000000000000000000000001
10000000000000000000000000000000000000000000000000000000000000000000000000000001
10000000000000000000000000000000000000000000000000000000000000000000000000000001
10000000000000000000000000000000000000000000000000000000000000000000000000000001
10000000000000000000000000000000000000000000000000000000000000000000000000000001
10000000000000000000000000000000000000000000000000000000000000000000000000000001
11111111111111111111111111111111111111111111111111111111111111111111111111111111