11111111111111111111111111111111111111111111111111111111111111111111
1E100000000000C00000000000000000000000000000000000000000000000000001
1100000000000000000000P000000000000000000000000000000000000000000001
11111111111111111111111111111111111111111111111111111111111111111111
