11111111111111111111111111111111111111111111111111111111111
10000001C10000000000000010000000000000000000000000000000001
10E00000000000000P00000010000000000000000000000000000000001
1000000000000000000000001C000000000000000000000000000000001
100000000000000000CCCCC101000000000000000000000000000000001
10000000000000000C00000001000000000000000000000000000000001
1000000000000000CCC0000001000000000000000000000000000000001
1000000000011111CCCCC10000000000000000000000000000000000001
10000000000000000000010000000000000000000000000000000000001
100000000000000000C0000000000000000000000000000000000000001
11111111111111111111111111111111111111111111111111111111111
