111111111111111111111111111111111111
10000001C100000000000000100000000001
10E00000000000000P000000100000000001
1000000000000000000000001C0000000001
100000000000000000000C01010000000001
10000000000000000C000000010000000001
10000000000000000C000000010000000001
100000000001111100000100000000000001
100000000000000000000100000000000001
100000000000000000C00000000000000001
111111111111111111111111111111111111
