11111111111111111111111111111111111111111111111111111111111111111111111111111111
100000000000000000000000000000000000000CCC00000000000000000000000000000000000001
100000000000000000000000000000000000000CEC00000000000000000000000000000000000001
10000000000000000000000000000000000000000000000000000000000000000000000000000001
1000000000000000000000000000000000000000P000000000000000000000000000000000000001
10000000000000000000000000000000000000000000000000000000000000000000000000000001
10000000000000000C00000000000000000000000000000000000000000000C00000000000000001
100000000000000000C000000000000000000000000000000000000000000C000000000000000001
1000000000000000000C0000000000000000000000000000000000000000C0000000000000000001
10000000000000000000C00000000000000000000000000000000000000C00000000000000000001
100000000000000C00000C000000000000000000000000000000000000C00000C000000000000001
100000000000000CCCC000C0000000000000000000000000000000000C000CCCC000000000000001
100000000000000CCCCC000C00000000000000000000000000000000C000CCCCC000000000000001
100000000000000CCCCC0000000000000000000000000000000000000000CCCCC000000000000001
10000000000000000000000000000000000000000000000000000000000000000000000000000001
10000000000000000000000000000000000000000000000000000000000000000000000000000001
10000000000000000000000000000000000000000000000000000000000000000000000000000001
10000000000000000000000000000000000000000000000000000000000000000000000000000001
10000000000000000CCCCCCCCCCCCCCCCCCCCCCCCCCCCCCCCCCCCCCCCCCCCCC00000000000000001
10000000000000000C00000000000000000000000000000000000000000000C00000000000000001
10000000000000000CC000000000000000000000000000000000000000000CC00000000000000001
100000000000000000CC0000000000000000000000000000000000000000CC000000000000000001
1000000000000000000CC00000000000000000000000000000000000000CC0000000000000000001
10000000000000000000CC000000000000000000000000000000000000CC00000000000000000001
100000000000000000000CC0000000000000000000000000000000000CC000000000000000000001
1000000000000000000000CCCCCCCCCCCCCCCCCCCCCCCCCCCCCCCCCCCC0000000000000000000001
10000000000000000000000000000000000000000000000000000000000000000000000000000001
10000000000000000000000000000000000000000000000000000000000000000000000000000001
10000000000000000000000000000000000000000000000000000000000000000000000000000001
10000000000000000000000000000000000000000000000000000000000000000000000000000001
10000000000000000000000000000000000000000000000000000000000000000000000000000001
10000000000000000000000000000000000000000000000000000000000000000000000000000001
11111111111111111111111111111111111111111111111111111111111111111111111111111111
